ぎそうかん	偽相関	名詞
きむかせつ	帰無仮説	名詞
きょうへんりょう	共変量	名詞
ぐんかんへいほうわ	群間平方和	名詞
ぐんないへいほうわ	群内平方和	名詞
こうごさよう	交互作用	名詞
ごすうようやく	五数要約	名詞
こんげんじしょう	根元事象	名詞
さいきょうりょくけんてい	最強力検定	名詞
さいひんち	最頻値	名詞
ざんさへいほうわ	残差平方和	名詞
しぶんいすう	四分位数	名詞
しぶんいてん	四分位点	名詞
しぶんいはんい	四分位範囲	名詞
しぶんいへんさ	四分位偏差	名詞
すいじゅんかんへいほうわ	水準間平方和	名詞
せんど	尖度	名詞
そうべつ	層別	名詞サ変
たじゅうきょうせんせい	多重共線性	名詞
ひせつめいへんすう	被説明変数	名詞
ふへんせい	不偏性	名詞
ぶんいすう	分位数	名詞
ぶんいち	分位値	名詞
ぶんいてん	分位点	名詞
へんかいきけいすう	偏回帰係数	名詞
へんそうかん	偏相関	名詞
へんそうかんけいすう	偏相関係数	名詞
わいど	歪度	名詞
